0 2 2 2 2 1
1 1 2 3 2 1
1 5 2 2 2 1
2 8 2 1 2 6
1 4 2 1 1 1
4 2 2 2 2 7