0 2 2 2 2 5
2 1 2 3 1 1
2 1 2 2 2 6
2 2 2 4 2 1
4 8 2 2 2 2
2 2 3 3 1 7
