0 1 1 5 1 8
2 2 2 2 2 2
4 1 1 1 3 2
7 2 2 1 2 2
1 2 8 1 2 1
4 2 2 2 2 6