0 2 1 2 2 5
2 2 1 2 8 1
2 3 1 2 2 2
2 2 1 2 3 2
4 2 8 2 1 2
6 2 2 2 1 7