0 2 3 7 8 1
1 2 1 2 2 2
2 2 1 2 3 2
2 2 1 2 2 5
2 4 1 2 8 1
2 2 2 2 6 1