0 2 2 2 3 6
1 1 8 2 1 2
5 2 2 2 1 2
1 2 1 4 1 2
1 2 3 1 8 2
7 2 2 2 2 2